1,Portal 2,620,396967,5228,402195,0.977,2024-08-05 12:03
2,People Playground,1118200,250558,3472,254030,0.9749,2024-08-05 12:03
3,Stardew Valley,413150,728505,12560,741065,0.9748,2024-08-05 12:03
4,Vampire Survivors,1794680,229659,3456,233115,0.9734,2024-08-05 12:03
5,Hades,1145360,261327,4457,265784,0.972,2024-08-05 12:03
6,Portal,400,159934,2485,162419,0.9716,2024-08-05 12:03
7,HoloCure - Save the Fans!,2420510,30232,222,30454,0.9706999999999999,2024-08-05 12:03
8,Terraria,105600,1284808,31627,1316435,0.9691,2024-08-05 12:03
10,Half-Life: Alyx,546560,88578,1510,90088,0.9677,2024-08-05 12:03
9,RimWorld,294100,187471,3824,191295,0.9677,2024-08-05 12:03
11,Left 4 Dead 2,550,855747,21839,877586,0.9673999999999999,2024-08-05 12:03
12,The Henry Stickmin Collection,1089980,44960,616,45576,0.9672,2024-08-05 12:03
14,Senren＊Banka,1144400,24173,233,24406,0.9670000000000001,2024-08-05 12:03
13,Pizza Tower,2231450,59190,920,60110,0.9670000000000001,2024-08-05 12:03
15,A Short Hike,1055540,16786,129,16915,0.9661,2024-08-05 12:03
16,Euro Truck Simulator 2,227300,766858,20572,787430,0.9659,2024-08-05 12:03
17,Slay the Spire,646570,158018,3502,161520,0.9654,2024-08-05 12:03
18,Slime Rancher,433340,120622,2562,123184,0.9651000000000001,2024-08-05 12:03
19,ULTRAKILL,1229490,119410,2566,121976,0.9649,2024-08-05 12:03
21,Totally Accurate Battle Simulator,508440,123206,2714,125920,0.9645,2024-08-05 12:03
20,Mount & Blade: Warband,48700,158343,3662,162005,0.9645,2024-08-05 12:03
22,The Binding of Isaac: Rebirth,250900,288281,7352,295633,0.9643999999999999,2024-08-05 12:03
23,Lethal Company,1966720,407345,10985,418330,0.9641,2024-08-05 12:03
25,Cats Hidden in Paris,2313250,15958,155,16113,0.9638,2024-08-05 12:03
24,OneShot,420530,45247,789,46036,0.9638,2024-08-05 12:03
27,Helltaker,1289310,116966,2646,119612,0.9637,2024-08-05 12:03
26,Half-Life 2,220,192509,4763,197272,0.9637,2024-08-05 12:03
29,Cats Hidden in Jingle Jam,2608050,8998,40,9038,0.9636,2024-08-05 12:03
28,Katana ZERO,460950,65392,1293,66685,0.9636,2024-08-05 12:03
30,VPet,1920960,40232,686,40918,0.9634999999999999,2024-08-05 12:03
31,Counter-Strike,10,233466,6142,239608,0.963,2024-08-05 12:03
32,Bloons TD 6,960090,312669,8610,321279,0.9628,2024-08-05 12:03
33,Resident Evil 4,2050650,139968,3447,143415,0.9626,2024-08-05 12:03
34,BeamNG.drive,284160,255168,7063,262231,0.9620000000000001,2024-08-05 12:03
36,ATRI -My Dear Moments-,1230140,17494,221,17715,0.9619,2024-08-05 12:03
35,Plants vs. Zombies: Game of the Year,3590,125962,3145,129107,0.9619,2024-08-05 12:03
38,Papa's Freezeria Deluxe,2291760,9043,65,9108,0.9612,2024-08-05 12:03
37,Deep Rock Galactic,548430,295195,8583,303778,0.9612,2024-08-05 12:03
39,Hollow Knight,367520,352904,10503,363407,0.9611,2024-08-05 12:03
40,Dyson Sphere Program,1366540,78184,1866,80050,0.9608,2024-08-05 12:03
42,A Hat in Time,253230,49022,1048,50070,0.9606,2024-08-05 12:03
41,Dishonored,205100,77414,1858,79272,0.9606,2024-08-05 12:03
43,Celeste,504230,100486,2553,103039,0.9605,2024-08-05 12:03
44,Garry's Mod,4000,1053720,35532,1089252,0.9603,2024-08-05 12:03
45,Entropy : Zero 2,1583720,23807,403,24210,0.9601999999999999,2024-08-05 12:03
46,Rhythm Doctor,774181,19661,311,19972,0.9598,2024-08-05 12:03
49,Our Life: Beginnings & Always,1129190,11255,124,11379,0.9597,2024-08-05 12:03
48,Stray,1332010,138797,3861,142658,0.9597,2024-08-05 12:03
47,tModLoader,1281930,255695,7725,263420,0.9597,2024-08-05 12:03
51,Firework,1288310,38464,805,39269,0.9595999999999999,2024-08-05 12:03
50,Baldur's Gate 3,1086940,616897,20432,637329,0.9595999999999999,2024-08-05 12:03
52,The Room 4: Old Sins,1361320,14563,203,14766,0.9592,2024-08-05 12:03
53,Dead Cells,588650,150767,4378,155145,0.9589,2024-08-05 12:03
55,Sheepy: A Short Adventure,1568400,10110,111,10221,0.9588,2024-08-05 12:03
54,South Park™: The Stick of Truth™,213670,60591,1490,62081,0.9588,2024-08-05 12:03
56,The Chronicles Of Myrtana: Archolos,1467450,14345,206,14551,0.9587,2024-08-05 12:03
57,Grimm's Hollow,1170880,13051,178,13229,0.9586,2024-08-05 12:03
58,DAVE THE DIVER,1868140,104186,2929,107115,0.9581999999999999,2024-08-05 12:03
59,The WereCleaner,2795000,4506,11,4517,0.9581000000000001,2024-08-05 12:03
60,OMORI,1150690,69956,1837,71793,0.958,2024-08-05 12:03
61,Subnautica,264710,270423,8740,279163,0.9579000000000001,2024-08-05 12:03
62,Volcano Princess,1669980,34064,756,34820,0.9578,2024-08-05 12:03
63,Chants of Sennaar,1931770,15044,242,15286,0.9575,2024-08-05 12:03
65,TOEM,1307580,6451,49,6500,0.9573999999999999,2024-08-05 12:03
64,Hotline Miami,219150,94556,2694,97250,0.9573999999999999,2024-08-05 12:03
66,The Wolf Among Us,250320,32820,736,33556,0.9573,2024-08-05 12:03
67,Satisfactory,526870,160437,5039,165476,0.9569,2024-08-05 12:03
70,Crab Champions,774801,22146,447,22593,0.9567,2024-08-05 12:03
69,Brotato,1942280,75592,2129,77721,0.9567,2024-08-05 12:03
68,Resident Evil 2,883710,153450,4834,158284,0.9567,2024-08-05 12:03
72,Neon White,1533420,15253,266,15519,0.9564,2024-08-05 12:03
71,The Room,288160,26523,581,27104,0.9564,2024-08-05 12:03
73,"Papers, Please",239030,67917,1918,69835,0.9561,2024-08-05 12:03
75,STAR WARS™ Empire at War: Gold Pack,32470,35713,872,36585,0.956,2024-08-05 12:03
74,BattleBlock Theater,238460,68654,1949,70603,0.956,2024-08-05 12:03
76,Pineapple on pizza,2263010,22065,464,22529,0.9559000000000001,2024-08-05 12:03
78,Steam Engine Simulator,2381620,6980,74,7054,0.9555,2024-08-05 12:03
77,The Walking Dead,207610,66190,1905,68095,0.9555,2024-08-05 12:03
79,Inscryption,1092790,112985,3568,116553,0.9554,2024-08-05 12:03
80,Undertale,391540,227242,7857,235099,0.9553,2024-08-05 12:03
84,VTOL VR,667970,16481,321,16802,0.9551999999999999,2024-08-05 12:03
83,Phoenix Wright: Ace Attorney Trilogy,787480,30730,745,31475,0.9551999999999999,2024-08-05 12:03
82,American Truck Simulator,270880,152744,5050,157794,0.9551999999999999,2024-08-05 12:03
81,Factorio,427520,181227,6121,187348,0.9551999999999999,2024-08-05 12:03
86,Placid Plastic Duck Simulator,1999360,14428,270,14698,0.9548000000000001,2024-08-05 12:03
85,Balatro,2379780,44646,1214,45860,0.9548000000000001,2024-08-05 12:03
87,There Is No Game: Wrong Dimension,1240210,21387,475,21862,0.9547,2024-08-05 12:03
88,VA-11 Hall-A: Cyberpunk Bartender Action,447530,33666,862,34528,0.9545999999999999,2024-08-05 12:03
89,Persona 4 Golden,1113000,68771,2072,70843,0.9544,2024-08-05 12:03
90,CLANNAD,324160,8771,128,8899,0.9542,2024-08-05 12:03
91,Bomb Rush Cyberfunk,1353230,10538,174,10712,0.9541,2024-08-05 12:03
94,Project Kat - Paper Lily Prologue,1698960,4743,36,4779,0.9540000000000001,2024-08-05 12:03
93,Baba Is You,736260,19923,446,20369,0.9540000000000001,2024-08-05 12:03
92,东方夜雀食堂 - Touhou Mystia's Izakaya,1584090,22475,524,22999,0.9540000000000001,2024-08-05 12:03
95,PowerWash Simulator,1290000,44047,1248,45295,0.9537,2024-08-05 12:03
96,Oxygen Not Included,457140,114111,3833,117944,0.9536,2024-08-05 12:03
98,One Finger Death Punch,264200,15903,336,16239,0.9534,2024-08-05 12:03
97,Finding Paradise,337340,17040,371,17411,0.9534,2024-08-05 12:03
100,The Room Two,425580,18208,411,18619,0.9531999999999999,2024-08-05 12:03
99,Doki Doki Literature Club,698780,193935,7040,200975,0.9531999999999999,2024-08-05 12:03
101,The Witcher 3: Wild Hunt,292030,758733,31047,789780,0.953,2024-08-05 12:03
103,Hi-Fi RUSH,1817230,30026,802,30828,0.9529000000000001,2024-08-05 12:03
102,Don't Starve,219740,103767,3517,107284,0.9529000000000001,2024-08-05 12:03
106,Ravenfield,636480,66489,2126,68615,0.9526,2024-08-05 12:03
105,Persona 5 Royal,1687950,71949,2329,74278,0.9526,2024-08-05 12:03
104,Ori and the Will of the Wisps,1057090,124857,4389,129246,0.9526,2024-08-05 12:03
107,Broforce,274190,55428,1719,57147,0.9525,2024-08-05 12:03
109,SANABI,1562700,27279,724,28003,0.9523999999999999,2024-08-05 12:03
108,POSTAL 2,223470,99738,3420,103158,0.9523999999999999,2024-08-05 12:03
110,Dishonored RHCP,217980,13186,273,13459,0.9523,2024-08-05 12:03
112,Wobbledogs,1424330,10051,184,10235,0.9521,2024-08-05 12:03
111,Iron Snout,424280,16900,390,17290,0.9521,2024-08-05 12:03
113,Cookie Clicker,1454400,65404,2126,67530,0.9520000000000001,2024-08-05 12:03
116,An Arcade Full of Cats,2368470,5722,71,5793,0.9518000000000001,2024-08-05 12:03
115,Just Shapes & Beats,531510,19427,478,19905,0.9518000000000001,2024-08-05 12:03
114,Half-Life,70,126436,4552,130988,0.9518000000000001,2024-08-05 12:03
118,The Case of the Golden Idol,1677770,6694,97,6791,0.9516,2024-08-05 12:03
117,Before Your Eyes,1082430,14005,308,14313,0.9516,2024-08-05 12:03
120,A Castle Full of Cats,2070550,3442,21,3463,0.9515,2024-08-05 12:03
119,Phasmophobia,739630,667767,28195,695962,0.9515,2024-08-05 12:03
121,God of War,1593500,129489,4745,134234,0.9514,2024-08-05 12:03
123,20 Small Mazes,2570630,5170,61,5231,0.9512,2024-08-05 12:03
122,INSIDE,304430,58459,1921,60380,0.9512,2024-08-05 12:03
126,Kind Words,1070710,8612,155,8767,0.951,2024-08-05 12:03
125,Half-Life 2: Episode Two,420,39567,1214,40781,0.951,2024-08-05 12:03
124,Cuphead,268910,160276,6079,166355,0.951,2024-08-05 12:03
129,魔女的夜宴,2458530,5378,68,5446,0.9509000000000001,2024-08-05 12:03
128,Stronghold Crusader HD,40970,17704,439,18143,0.9509000000000001,2024-08-05 12:03
127,DUSK,519860,21553,569,22122,0.9509000000000001,2024-08-05 12:03
131,星空列车与白的旅行,1567800,4052,37,4089,0.9508,2024-08-05 12:03
130,Keep Talking and Nobody Explodes,341800,13480,304,13784,0.9508,2024-08-05 12:03
132,Gorogoa,557600,16163,392,16555,0.9506999999999999,2024-08-05 12:03
134,Outlast,238320,113349,4180,117529,0.9506,2024-08-05 12:03
133,Counter-Strike: Source,240,166822,6428,173250,0.9506,2024-08-05 12:03
135,Blade & Sorcery,629730,50339,1647,51986,0.9505,2024-08-05 12:03
137,Tales of the Black Forest,1093910,12323,273,12596,0.9504,2024-08-05 12:03
136,Risk of Rain 2,632360,270661,11001,281662,0.9504,2024-08-05 12:03
139,Lil Gator Game,1586800,4135,41,4176,0.9503,2024-08-05 12:03
138,A Date with Death,2415010,6368,98,6466,0.9503,2024-08-05 12:03
141,Patrick's Parabox,1260520,3487,27,3514,0.9501999999999999,2024-08-05 12:03
140,Tomb Raider,203160,225798,9079,234877,0.9501999999999999,2024-08-05 12:03
143,Purrgatory,1713610,4060,41,4101,0.95,2024-08-05 12:03
142,The Hungry Lamb: Traveling in the Late Ming Dynasty,2593370,31272,945,32217,0.95,2024-08-05 12:03
146,Juice Galaxy,1708150,5141,68,5209,0.9499,2024-08-05 12:03
145,STEINS;GATE,412830,16827,429,17256,0.9499,2024-08-05 12:03
144,The Murder of Sonic the Hedgehog,2324650,20737,566,21303,0.9499,2024-08-05 12:03
148,Sid Meier's Civilization V,8930,191015,7666,198681,0.9497,2024-08-05 12:03
147,Fallout: New Vegas,22380,206209,8326,214535,0.9497,2024-08-05 12:03
150,Paper Lily - Chapter 1,2220360,3658,33,3691,0.9495999999999999,2024-08-05 12:03
149,Touhou Luna Nights,851100,13030,308,13338,0.9495999999999999,2024-08-05 12:03
153,Ib,1901370,3685,34,3719,0.9495,2024-08-05 12:03
152,文字遊戲：第零章,1507970,4462,53,4515,0.9495,2024-08-05 12:03
151,CULTIC,1684930,6012,94,6106,0.9495,2024-08-05 12:03
155,Epic Battle Fantasy 5,432350,5108,70,5178,0.9494,2024-08-05 12:03
154,Life is Strange™,319630,159179,6319,165498,0.9494,2024-08-05 12:03
157,"Please, Touch The Artwork 2",2600140,2888,17,2905,0.9493,2024-08-05 12:03
156,GRIS,683320,70046,2515,72561,0.9493,2024-08-05 12:03
158,东北之夏,2121360,11566,266,11832,0.9490999999999999,2024-08-05 12:03
159,I Wani Hug that Gator!,1895350,2903,19,2922,0.9488,2024-08-05 12:03
161,Riddle Joker,1277930,5113,74,5187,0.9487000000000001,2024-08-05 12:03
160,Webbed,1390350,12545,305,12850,0.9487000000000001,2024-08-05 12:03
162,A Building Full of Cats,1969080,3565,36,3601,0.9484,2024-08-05 12:03
163,Cube Escape Collection,1292940,5964,101,6065,0.9481999999999999,2024-08-05 12:03
164,Trombone Champ,1059990,8646,184,8830,0.9481,2024-08-05 12:03
166,100 hidden frogs,1806840,5709,95,5804,0.948,2024-08-05 12:03
165,山河旅探 Murders on the Yangtze River,1746030,12196,302,12498,0.948,2024-08-05 12:03
168,Gunpoint,206190,12335,309,12644,0.9479000000000001,2024-08-05 12:03
167,Sally Face - Episode One,541570,18410,526,18936,0.9479000000000001,2024-08-05 12:03
169,Don't Starve Together,322330,442837,20006,462843,0.9478,2024-08-05 12:03
173,Virtual Cottage,1369320,9300,210,9510,0.9476,2024-08-05 12:03
172,Outcore,1275670,12125,305,12430,0.9476,2024-08-05 12:03
171,The Expendabros,312990,17573,500,18073,0.9476,2024-08-05 12:03
170,To the Moon,206440,72897,2772,75669,0.9476,2024-08-05 12:03
175,Underground Blossom,2291850,5388,89,5477,0.9475,2024-08-05 12:03
174,Castle Crashers,204360,111220,4476,115696,0.9475,2024-08-05 12:03
177,Eternal Senia,351640,11579,289,11868,0.9473999999999999,2024-08-05 12:03
176,Milk inside a bag of milk inside a bag of milk,1392820,25032,790,25822,0.9473999999999999,2024-08-05 12:03
180,LIZARDS MUST DIE,2532550,24037,752,24789,0.9473,2024-08-05 12:03
179,Clone Drone in the Danger Zone,597170,28005,908,28913,0.9473,2024-08-05 12:03
178,Divinity: Original Sin 2,435150,173721,7368,181089,0.9473,2024-08-05 12:03
182,West of Loathing,597220,9059,206,9265,0.9472,2024-08-05 12:03
181,Slay the Princess,1989270,13376,355,13731,0.9472,2024-08-05 12:03
183,"Hot Dogs, Horseshoes & Hand Grenades",450540,19894,603,20497,0.9469,2024-08-05 12:03
185,東方天空璋 ～ Hidden Star in Four Seasons.,745880,4408,65,4473,0.9468000000000001,2024-08-05 12:03
184,Gravitas,1067310,6487,127,6614,0.9468000000000001,2024-08-05 12:03
186,The Forest,242760,528461,24866,553327,0.9466,2024-08-05 12:03
187,Fran Bow,362680,16253,472,16725,0.9465,2024-08-05 12:03
188,Batman: Arkham Asylum GOTY Edition,35140,62887,2434,65321,0.9462999999999999,2024-08-05 12:03
193,SuchArt: Creative Space,1469280,6669,137,6806,0.9462,2024-08-05 12:03
192,Mon Bazou,1520370,12288,331,12619,0.9462,2024-08-05 12:03
191,Milk outside a bag of milk outside a bag of milk,1604000,15083,433,15516,0.9462,2024-08-05 12:03
190,Super Hexagon,221640,23558,764,24322,0.9462,2024-08-05 12:03
189,Duck Game,312530,36371,1290,37661,0.9462,2024-08-05 12:03
195,Wobbly Life,1211020,21125,670,21795,0.9460999999999999,2024-08-05 12:03
194,Left 4 Dead,500,54884,2096,56980,0.9460999999999999,2024-08-05 12:03
198,Lost in Play,1328840,5538,103,5641,0.946,2024-08-05 12:03
197,The Test,1241510,18933,585,19518,0.946,2024-08-05 12:03
196,Return of the Obra Dinn,653530,25027,827,25854,0.946,2024-08-05 12:03
200,Aventura Copilului Albastru și Urât,1530140,2412,17,2429,0.9458,2024-08-05 12:03
199,Kingdom Rush,246420,13020,363,13383,0.9458,2024-08-05 12:03
203,Summer Pockets,897220,3394,42,3436,0.9457,2024-08-05 12:03
202,DOOM (1993),2280,17630,541,18171,0.9457,2024-08-05 12:03
201,Doki Doki Literature Club Plus!,1388880,23400,771,24171,0.9457,2024-08-05 12:03
204,The Looker,1985690,13257,375,13632,0.9456,2024-08-05 12:03
205,MADNESS: Project Nexus,488860,14006,405,14411,0.9455,2024-08-05 12:03
206,Mirror,644560,83090,3423,86513,0.9454,2024-08-05 12:03
208,The Supper,1171370,3675,52,3727,0.9451999999999999,2024-08-05 12:03
207,第七号列车 - Train No. 7,1708870,6285,132,6417,0.9451999999999999,2024-08-05 12:03
210,Monument Valley,1927720,4144,66,4210,0.9451,2024-08-05 12:03
209,海沙风云 Far Away,1250760,6209,130,6339,0.9451,2024-08-05 12:03
211,Zup! S,617670,13583,397,13980,0.945,2024-08-05 12:03
213,Maitetsu:Last Run!!,1434480,3951,61,4012,0.9449,2024-08-05 12:03
212,箭箭剑 Arrow a Row,2495980,14371,428,14799,0.9449,2024-08-05 12:03
214,The Last Campfire,990630,9487,246,9733,0.9448000000000001,2024-08-05 12:03
216,Mark of the Ninja,214560,15331,473,15804,0.9445,2024-08-05 12:03
215,METAL GEAR RISING: REVENGEANCE,235460,73722,3065,76787,0.9445,2024-08-05 12:03
217,WolfQuest: Anniversary Edition,926990,7916,194,8110,0.9444,2024-08-05 12:03
221,Hylics,397740,4996,96,5092,0.9443,2024-08-05 12:03
220,NEKOPARA Vol. 2,420110,12137,351,12488,0.9443,2024-08-05 12:03
219,Cruelty Squad,1388770,17366,557,17923,0.9443,2024-08-05 12:03
218,Devil May Cry 5,601150,122066,5402,127468,0.9443,2024-08-05 12:03
222,NEKOPARA Vol. 4,1406990,8200,206,8406,0.9442,2024-08-05 12:03
225,SIGNALIS,1262350,18795,620,19415,0.9440999999999999,2024-08-05 12:03
224,LEGO® Star Wars™: The Complete Saga,32440,21839,748,22587,0.9440999999999999,2024-08-05 12:03
223,Marvel’s Spider-Man Remastered,1817070,93077,4028,97105,0.9440999999999999,2024-08-05 12:03
228,Cube Escape: Paradox,909080,9274,247,9521,0.9440000000000001,2024-08-05 12:03
227,Dorfromantik,1455840,25235,894,26129,0.9440000000000001,2024-08-05 12:03
226,Batman: Arkham City GOTY,200260,60225,2473,62698,0.9440000000000001,2024-08-05 12:03
229,The Test: Final Revelation,1428310,5146,103,5249,0.9439,2024-08-05 12:03
230,planetarian HD,623080,2684,30,2714,0.9437000000000001,2024-08-05 12:03
232,Half-Life 2: VR Mod,658920,5845,129,5974,0.9434999999999999,2024-08-05 12:03
231,Post Void,1285670,9810,272,10082,0.9434999999999999,2024-08-05 12:03
235,Alba: A Wildlife Adventure,1337010,5620,122,5742,0.9434,2024-08-05 12:03
234,乡村狂想曲,2109460,14456,456,14912,0.9434,2024-08-05 12:03
233,The Coffin of Andy and Leyley,2378900,21192,736,21928,0.9434,2024-08-05 12:03
239,Tiny Bunny,1421250,17884,602,18486,0.9431999999999999,2024-08-05 12:03
238,Stacklands,1948280,23129,826,23955,0.9431999999999999,2024-08-05 12:03
237,Age of Empires II (2013),221380,95641,4242,99883,0.9431999999999999,2024-08-05 12:03
236,Sekiro™: Shadows Die Twice,814380,278320,13572,291892,0.9431999999999999,2024-08-05 12:03
241,巫兎 - KANNAGI USAGI -,2551500,5367,115,5482,0.9431,2024-08-05 12:03
240,NEKOPARA Vol. 3,602520,11496,342,11838,0.9431,2024-08-05 12:03
245,Cafe Stella,1829980,4000,71,4071,0.943,2024-08-05 12:03
244,Bloody Hell,2056220,4834,98,4932,0.943,2024-08-05 12:03
243,Pseudoregalia,2365810,10061,288,10349,0.943,2024-08-05 12:03
242,The Walking Dead: Season Two,261030,28856,1082,29938,0.943,2024-08-05 12:03
248,Monster Prom 3: Monster Roadtrip,1665190,2789,36,2825,0.9427,2024-08-05 12:03
247,The Test: Hypothesis Rising,1282200,5637,127,5764,0.9427,2024-08-05 12:03
246,Samsara Room,1281800,8231,221,8452,0.9427,2024-08-05 12:03
249,BAD END THEATER,1764390,7104,180,7284,0.9426000000000001,2024-08-05 12:03
250,Dying Light,239140,402696,20453,423149,0.9425,2024-08-05 12:03
